9,10,11,12,13,14,15,16,17,18,19,20,21,22,23,9,10,11,12,13,14,15,16,17,18,19,20,21,22,23,9,10,11,12,13,14,15,16,17,18
9,10,11,12,13,14,15,16,17,18,19,20,21,22,23,9,10,11,12,13,14,15,16,17,18,19,20,21,22,23,9,10,11,12,13,14,15,16,17,18
9,10,11,12,13,14,15,16,17,18,19,20,21,22,23,9,10,11,12,13,14,15,16,17,18,19,20,21,22,23,9,10,11,12,13,14,15,16,17,18
9,10,11,12,13,14,15,16,17,18,19,20,21,22,23,9,10,11,12,13,14,15,16,17,18,19,20,21,22,23,9,10,11,12,13,14,15,16,17,18
9,10,11,12,13,14,15,16,17,18,19,20,21,22,23,9,10,11,12,13,14,15,16,17,18,19,20,21,22,23,9,10,11,12,13,14,15,16,17,18
9,10,11,12,13,14,15,16,17,18,19,20,21,22,23,9,10,11,12,13,14,15,16,17,18,19,20,21,22,23,9,10,11,12,13,14,15,16,17,18
9,10,11,12,13,14,15,16,17,18,19,20,21,22,23,9,10,11,12,13,14,15,16,17,18,19,20,21,22,23,9,10,11,12,13,14,15,16,17,18
9,10,11,12,13,14,15,16,17,18,19,20,21,22,23,9,10,11,12,13,14,15,16,17,18,19,20,21,22,23,9,10,11,12,13,14,15,16,17,18
9,10,11,12,13,14,15,16,17,18,19,20,21,22,23,9,10,11,12,13,14,15,16,17,18,19,20,21,22,23,9,10,11,12,13,14,15,16,17,18
9,10,11,12,13,14,15,16,17,18,19,20,21,22,23,9,10,11,12,13,14,15,16,17,18,19,20,21,22,23,9,10,11,12,13,14,15,16,17,18
9,10,11,12,13,14,15,16,17,18,19,20,21,22,23,9,10,11,12,13,14,15,16,17,18,19,20,21,22,23,9,10,11,12,13,14,15,16,17,18
9,10,11,12,13,14,15,16,17,18,19,20,21,22,23,9,10,11,12,13,14,15,16,17,18,19,20,21,22,23,9,10,11,12,13,14,15,16,17,18
9,10,11,12,13,14,15,16,17,18,19,20,21,22,23,9,10,11,12,13,14,15,16,17,18,19,20,21,22,23,9,10,11,12,13,14,15,16,17,18
9,10,11,12,13,14,15,16,17,18,19,20,21,22,23,9,10,11,12,13,14,15,16,17,18,19,20,21,22,23,9,10,11,12,13,14,15,16,17,18
9,10,11,12,13,14,15,16,17,18,19,20,21,22,23,24,9,10,11,12,13,14,15,16,17,18,19,20,21,22,23,24,9,10,11,12,13,14,15,16
34,35,36,37,38,39,40,41,42,43,44,45,46,47,48,49,34,35,36,37,38,39,40,41,42,43,44,45,46,47,48,49,34,35,36,37,38,39,40,41
59,60,61,62,63,64,65,66,67,68,69,70,71,72,73,74,59,60,61,62,63,64,65,66,67,68,69,70,71,72,73,74,59,60,61,62,63,64,65,66
84,85,86,87,88,89,90,91,92,93,94,95,96,97,98,99,84,85,86,87,88,89,90,91,92,93,94,95,96,97,98,99,84,85,86,87,88,89,90,91
109,110,111,112,113,114,115,116,117,118,119,120,121,122,123,124,109,110,111,112,113,114,115,116,117,118,119,120,121,122,123,124,109,110,111,112,113,114,115,116
134,135,136,137,138,139,140,141,142,143,144,145,146,147,148,149,134,135,136,137,138,139,140,141,142,143,144,145,146,147,148,149,134,135,136,137,138,139,140,141
159,160,161,162,163,164,165,166,167,168,169,170,171,172,173,174,159,160,161,162,163,164,165,166,167,168,169,170,171,172,173,174,159,160,161,162,163,164,165,166
184,185,186,187,188,189,190,191,192,193,194,195,196,197,198,199,184,185,186,187,188,189,190,191,192,193,194,195,196,197,198,199,184,185,186,187,188,189,190,191
151,151,151,151,151,151,151,151,151,151,151,151,151,151,151,151,151,151,151,151,151,151,151,151,151,151,151,151,151,151,151,151,151,151,151,151,151,151,151,151
151,151,151,151,151,151,151,151,151,151,151,151,151,151,151,151,151,151,151,151,151,151,151,151,151,151,151,151,151,151,151,151,151,151,151,151,151,151,151,151
151,151,151,151,151,151,151,151,151,151,151,151,151,151,151,151,151,151,151,151,151,151,151,151,151,151,151,151,151,151,151,151,151,151,151,151,151,151,151,151
151,151,151,151,151,151,151,151,151,151,151,151,151,151,151,151,151,151,151,151,151,151,151,151,151,151,151,151,151,151,151,151,151,151,151,151,151,151,151,151
151,151,151,151,151,151,151,151,151,151,151,151,151,151,151,151,151,151,151,151,151,151,151,151,151,151,151,151,151,151,151,151,151,151,151,151,151,151,151,151
151,151,151,151,151,151,151,151,151,151,151,151,151,151,151,151,151,151,151,151,151,151,151,151,151,151,151,151,151,151,151,151,151,151,151,151,151,151,151,151
151,151,151,151,151,151,151,151,151,151,151,151,151,151,151,151,151,151,151,151,151,151,151,151,151,151,151,151,151,151,151,151,151,151,151,151,151,151,151,151
151,151,151,151,151,151,151,151,151,151,151,151,151,151,151,151,151,151,151,151,151,151,151,151,151,151,151,151,151,151,151,151,151,151,151,151,151,151,151,151
151,151,151,151,151,151,151,151,151,151,151,151,151,151,151,151,151,151,151,151,151,151,151,151,151,151,151,151,151,151,151,151,151,151,151,151,151,151,151,151
151,151,151,151,151,151,151,151,151,151,151,151,151,151,151,151,151,151,151,151,151,151,151,151,151,151,151,151,151,151,151,151,151,151,151,151,151,151,151,151
151,151,151,151,151,151,151,151,151,151,151,151,151,151,151,151,151,151,151,151,151,151,151,151,151,151,151,151,151,151,151,151,151,151,151,151,151,151,151,151
151,151,151,151,151,151,151,151,151,151,151,151,151,151,151,151,151,151,151,151,151,151,151,151,151,151,151,151,151,151,151,151,151,151,151,151,151,151,151,151
151,151,151,151,151,151,151,151,151,151,151,151,151,151,151,151,151,151,151,151,151,151,151,151,151,151,151,151,151,151,151,151,151,151,151,151,151,151,151,151
151,151,151,151,151,151,151,151,151,151,151,151,151,151,151,151,151,151,151,151,151,151,151,151,151,151,151,151,151,151,151,151,151,151,151,151,151,151,151,151
151,151,151,151,151,151,151,151,151,151,151,151,151,151,151,151,151,151,151,151,151,151,151,151,151,151,151,151,151,151,151,151,151,151,151,151,151,151,151,151
151,151,151,151,151,151,151,151,151,151,151,151,151,151,151,151,151,151,151,151,151,151,151,151,151,151,151,151,151,151,151,151,151,151,151,151,151,151,151,151
151,151,151,151,151,151,151,151,151,151,151,151,151,151,151,151,151,151,151,151,151,151,151,151,151,151,151,151,151,151,151,151,151,151,151,151,151,151,151,151
151,151,151,151,151,151,151,151,151,151,151,151,151,151,151,151,151,151,151,151,151,151,151,151,151,151,151,151,151,151,151,151,151,151,151,151,151,151,151,151
